8
10
0 0 0 0 3 0 0 1 6 0
2 1 1 4 5 2 1 1 1 4
1 1 1 0 0 1 1 1 1 1
0 2 3 4 5 6 7 8 9 10
0 0 0 0 3 0 0 1 6 0
2 1 1 4 5 2 1 1 1 4
1 1 1 0 0 1 1 1 1 1
0 2 3 4 5 6 7 8 9 10